 111111111111111111111  11111111111111111111
 100000000000000000011 11000000000000000001
 10000000000000000011 110000000000000000001
 1111111100000000111  100000000000000000001
        1000000001    100000000000000000001
    1111100000000111111000001111110000001111111
    1000000000000000000000001    10000000000001
    1000000000000000000000001    10000000000001
    11111100000000000E0000001111111000000000001
         10000000000000000000000000000000000001
         10000000000000000000000000000000000001
         10000000000000000001111110000000000001
    1111110000000000000000001    10000000000001
    1000000000000000000000001    10000000000001
    1111111111100111111111111    11111111111111
              1001
              1001
              1001
              10011111111
              10000000001
              10011111111
              1001
              1001
              1111