NO ./img/brickwall_dark.xpm
SO ./img/brickwall_gray.xpm
WE ./img/brickwall_ligth.xpm
EA ./img/brickwall_red.xpm

F 0,100,100
C 0,255,255

111111111111
100010000001
100011000001
100010000W01
111111111111
