11111111111
10000010001
10000000001
10000000W01
11111111111
