NO ./img/brickwall_dark.xpm
SO ./img/brickwall_gray.xpm
WE ./img/brickwall_ligth.xpm
EA ./img/brickwall_red.xpm

F 0,100,100
C 0,255,255

11111111111
10010000001
10010000001
100D0000W01
11111111111
