111111111111111111111111111111
1P000000000C10000C010000000001
101001010010000001010111110101
101011011011010101000100010101
10100C10C000001000011100P001C1
100000100000P01011110000000101
100000000000000000000000000001
100000100011111101110110000101
1P00001000000000001C0000000101
10000C000000000000001111011101
100000000000000000100000000001
100001111100010000000000010001
10000000000000000000P0000100E1
111111111111111111111111111111