1111111111111
1P01C000000P1
1000011111001
1000C1C001001
1000010000001
1000011111001
1P0C00E000C01
1111111111111