1111111111111111111111111111111111
1000000000P0000C10000C010000000001
1010010100100000101001110111110101
1110111110111110101111000100010101
1P1000000C10C000001000011100P001C1
1000000000100000001011110000000101
1000000000100000000000000000000101
1000000000100011111111111110000101
10000000001000000000001C0000000101
10000C0000000000000000101111111101
1000000000000000000000100000000001
1000011111111111110000000000010001
10000000000000C000000000P0000100E1
1111111111111111111111111111111111