1111111111111111111111111111111111
1P0000000000000C00000C000000000001
1010010100100000101001000000C10101
1010010010101010001001000001110101
1C000P00CC00C00000C0000000000000C1
110000P0CC00C000011000011000000PC1
1C010000111111110010000110000100C1
111100001C00C0000010000000000100C1
1C0000000C00C00000100000100000E0C1
1111111111111111111111111111111111