111111111111111111111111111111111111111
1E0000000000000C00000C00111110000000001
1010010100100000101001001   10000010101
1010010010101010001001001   10000010101
1P0000000C00C00000000000111110000111111
1111111111111111111111111111111111