1111111111111
1010000000C1
100011111001
10011E000001
1111111111111