 111111111111111111111  11111111111111111111
 1000P00000000000000011110000000000000P0001
 100000000000000000011100000000000000000001
 11111110000000001111 100000000000000000001
    1000000000000111111000001111110000001111111
    1000000000000000000000001    10000000000001
    1000001000000000P00000001    10000000000001
    1111111111111111111111111    11111111111111