1111111111111111111111111111111111111
100000000000000000000000000000000P001
1000000000000000000000000000000000001
1000000000000000000000000000000000001
1000000000000000000000000000000000001
1000000000000000000000000000000000001
1000000000000000000000000000000000001
1000000000000000000000000000000000001
1000000000000000000000000000000000001
1000000000000000000P00111110000000001
1010010010000010100100100010000010101
1010001010101000100100100010000010101
1P00000000000000000000111110000111111
1000000000000000000000000000000111111
1111111111111111111111111111111111111