NO ./img/Nigeria_64.xpm
SO ./img/Hungary_64.xpm
WE ./img/Germany_64.xpm
EA ./img/brickwall_red.xpm

F 0,100,100
C 0,255,255

1111111111111111111111111111111111111
1000000000000000000000000000000000001
1000000000000000000000000000000000001
1000000000000000000000000000000000001
1000000000000000000000000000000100011
1000000000000000000000000000001100001
1000000000000000000000000000000100001
1000000000000000000000000000000100001
1000000000000000000000000000000100001
1000000000000000000000000000000100001
1000000000000000000000000000000100001
1000000000000000000000000000000100001
1000000000000000000000000000000100001
1000000000000000000000000000000100001
1000000000000000000000000000000100001
1000000000000000000E00111110000000001
101001001000001D100100100010000010101
1010001010101000100100100010000010101
1000000000000000000000111110000111111
1000000000000000000000000000000111111
1111111111111111111111111111111111111